fweep
A map creator by Phil Riley
Release 1 / Serial number 260401 / Inform 7 v10.1.2 / D

Bat Cave
A dark passage leads west.

On the north wall is a sign saying "enter '\create Bat Cave'".

On the west wall is a sign saying "enter '\west is unknown'"

I beg your pardon?

I beg your pardon?

* * *

fweep
A map creator by Phil Riley
Release 1 / Serial number 260401 / Inform 7 v10.1.2 / D

Bat Cave
A dark passage leads west.

On the north wall is a sign saying "enter '\create Bat Cave'".

On the west wall is a sign saying "enter '\west is unknown'"

>read book
 Welcome to fweep! The map creator for people who like to type! And frankly, who hate switching from the keyboard to the mouse and back again.

fweep has an interactive visual editor, but it's meant to be primarily used through the keyboard, in the same window in which you're playing a game. You may play the game normally, or input mapping commands by prefixing them with "\". Here, let's try one: enter "\create Bat Cave".

Poof! Now there's a room called Bat Cave on your map! Now, assuming you're still hanging around in the Bat Cave, go west. Here's another room you'll probably want to put on your map. So type "\west of bat cave is Glass Maze", et voilà, you have a second room connected to the first.

That's all the basic stuff you need to know, but here's a few handy extras:

* Typing Ctrl+Space while in \ mode brings up auto-suggestions.
 * "\undo" is exactly what it sounds like.
 * if you want to record directions you could go on the map but haven't had time to yet, you can use, for instance, "\north of kitchen is unknown" to mark that on the map.
 * or, of course, you could type "\help".

Now go ahead and type "\choose a game"!

>w
Glass Maze
East of here is the Bat Cave.

* * *

fweep
A map creator by Phil Riley
Release 1 / Serial number 260401 / Inform 7 v10.1.2 / D

Bat Cave
A dark passage leads west.

On the north wall is a sign saying "enter '\create Bat Cave'".

On the west wall is a sign saying "enter '\west is unknown'"

>read. book
You can't see any such thing.

>read book
 Welcome to fweep! The map creator for people who like to type! And frankly, who hate switching from the keyboard to the mouse and back again.

fweep has an interactive visual editor, but it's meant to be primarily used through the keyboard, in the same window in which you're playing a game. You may play the game normally, or input mapping commands by prefixing them with "\". Here, let's try one: enter "\create Bat Cave".

Poof! Now there's a room called Bat Cave on your map! Now, assuming you're still hanging around in the Bat Cave, go west. Here's another room you'll probably want to put on your map. So type "\west of bat cave is Glass Maze", et voilà, you have a second room connected to the first.

That's all the basic stuff you need to know, but here's a few handy extras:

* Typing Ctrl+Space while in \ mode brings up auto-suggestions.
 * "\undo" is exactly what it sounds like
 * if you want to record directions you could go on the map but haven't had time to yet, you can use, for instance, "\north of kitchen is unknown" to mark that on the map.

* * *

fweep
A map creator by Phil Riley
Release 1 / Serial number 260401 / Inform 7 v10.1.2 / D

Bat Cave
A dark passage leads west.

On the north wall is a sign saying "enter '\create Bat Cave'".

On the west wall is a sign saying "enter '\west is unknown'"

>w
Glass Maze
A dark passage leads east and a stairway leads up.

Scribbled on the floor are the instructions "\west of Bat Cave is Glass Maze".

Etched in the ceiling is the inscription "\above is unknown".

>u
Darkness
It is pitch dark, and you can't see a thing.
A hollow voice says "frotz".

>frotz
Behold! Now the room is lit!

Dark Corner
Now that it's light, you see that this room is little more than a nook at the top of a narrow stair. It looks like you can just squeeze through a tight crack to the north.

Smoky tendrils float through the room. You can just make out a message in them: "\above Glass Maze is Dark Corner, which is dark"

>frotz
Nothing seems to happen.

>d
Glass Maze
A dark passage leads east and a stairway leads up.

Scribbled on the floor are the instructions "\west of Bat Cave is Glass Maze".

Etched in the ceiling is the inscription "\above is unknown".

>frotz
Nothing seems to happen.

* * *

>frotz
Behold! Now the room is lit!

Dark Corner
Now that it's light, you see that this room is little more than a nook at the top of a narrow stair. It looks like you can just squeeze through a tight crack to the north.

Smoky tendrils float through the room. You can just make out a message in them: "\above Glass Maze is Dark Corner, which is dark"

>u
You can't go that way.

>n
Treasure Room
The brillliance of this room is staggering, the light reflecting from a million coins and refracting through a thousand jewels. But you are not here for wealth, you are here for wisdom.

A choir of a hundred angels sings "\create Treasure Room north of Dark Corner".

A narrow crack leads south.

You can see a jewel-encrusted book here.

>read book
 Welcome to fweep! The map creator for people who like to type! And frankly, who hate switching from the keyboard to the mouse and back again.

fweep has an interactive visual editor, but it's meant to be primarily used through the keyboard, in the same window in which you're playing a game. You may play the game normally, or input mapping commands by prefixing them with "\".

Now enter "\put fweep instruction book in Treasure Room".

Here are some extra tips:

* Typing Ctrl+Space while in \ mode brings up auto-suggestions.
 * "\undo" is exactly what it sounds like.
 * or, of course, you could type "\help".

Now go ahead and type "\choose a game"!

* * *

>frotz
Behold! Now the room is lit!

Dark Corner
Now that it's light, you see that this room is little more than a nook at the top of a narrow stair. It looks like you can just squeeze through a tight crack to the north.

Smoky tendrils float through the room. You can just make out a message in them: "\above Glass Maze is Dark Corner, which is dark"

>undo
Darkness
[Previous turn undone.]

>z
Time passes.

>z
Time passes.

>l
Darkness
It is pitch dark, and you can't see a thing.

A hollow voice says "frotz".

* * *

>u
Darkness
It is pitch dark, and you can't see a thing.
A hollow voice says "frotz".

>l
Darkness
It is pitch dark, and you can't see a thing.
A hollow voice says "frotz".

>frotz
Behold! Now the room is lit!

Dark Corner
Now that it's light, you see that this room is little more than a nook at the top of a narrow stair.

You can see a fweep instruction book here.

>frotz
Behold! Now the room is lit!

* * *

>u
Darkness
It is pitch dark, and you can't see a thing.
A hollow voice says "frotz".

>z
Time passes.

>l
Darkness
It is pitch dark, and you can't see a thing.

>frotz
Behold! Now the room is lit!

Dark Corner
Now that it's light, you see that this room is little more than a nook at the top of a narrow stair.

You can see a fweep instruction book here.

* * *

>w
Glass Maze
A dark passage leads east and a stairway leads up.

Scribbled on the floor are the instructions "\west of Bat Cave is Glass Maze".

Etched in the ceiling is the inscription "\above is unknown".

>up
Darkness
It is pitch dark, and you can't see a thing.
A hollow voice says "frotz".

>frotz
Behold! Now the room is lit!

Dark Corner
Now that it's light, you see that this room is little more than a nook at the top of a narrow stair. It looks like you can just squeeze through a tight crack to the north.

Smoky tendrils float through the room. You can just make out a message in them: "\above Glass Maze is Dark Corner, which is dark"

>n
Treasure Room
The brillliance of this room is staggering, the light reflecting from a million coins and refracting through a thousand jewels. But you are not here for wealth, you are here for wisdom.

A narrow crack leads south.

You can see a jewel-encrusted book here.

>read book
 Welcome to fweep! The map creator for people who like to type! And frankly, who hate switching from the keyboard to the mouse and back again.

fweep has an interactive visual editor, but it's meant to be primarily used through the keyboard, in the same window in which you're playing a game. You may play the game normally, or input mapping commands by prefixing them with "\".

Now enter "\put fweep instruction book in Dark Corner".

Here are some extra tips:

* Typing Ctrl+Space while in \ mode brings up auto-suggestions.
 * "\undo" is exactly what it sounds like.
 * if you want to record directions you could go on the map but haven't had time to yet, you can use, for instance, "\north of kitchen is unknown" to mark that on the map.
 * or, of course, you could type "\help".

Now go ahead and type "\choose a game"!